S.##.....T
#T##..###.
#.###E###E
#...E.###.
###T#####G
         